1000000000000000000000000000000000000000000000000000000000000000000000000000000000000000000000000001
1000000000000000000000000000000000000000000111101111011110000000000000000000000000000000000000000001
1000000000000000000000000000000000000000000111101111011110000000000000000000000000000000000000000001
1000000000000000000000000000000000000000000111101111011110000000000000000000000000000000000000000001
1000000000000000000000000000000000000000000111101111011110000000000000000000000000000000000000000001
1000000000000000000000000000000000000000000111101111011110000000000000000000000000000000000000000001
1000000000000000000000000000000000000000000111101111011110000000000000000000000000000000000000000001
1000000000000000000000000000000000000000000111101111011110000000000000000000000000000000000000000001
1000000000000000000000000000000000000000000111101111011110000000000000000000000000000000000000000001
1000000000000000000000000000000000000000000111101111011110000000000000000000000000000000000000000001
1000000000000000000000000000000000000000000111101111011110000000000000000000000000000000000000000001
1000000000000000000000000000000000000000000111101111011110000000000000000000000000000000000000000001
1000000000000000000000000000000000000000000111101111011110000000000000000000000000000000000000000001
1000000000000000000000000000000000000000000111101111011110000000000000000000000000000000000000000001
1000000000000000000000000000000000000000000111101111011110000000000000000000000000000000000000000001
1000000000000000000000000000000000000000000111101111011110000000000000000000000000000000000000000001
1000000000000000000000000000000000000000000111101111011110000000000000000000000000000000000000000001
1000000000000000000000000000000000000000000111101111011110000000000000000000000000000000000000000001
1000000000000000000000000000000000000000000111101111011110000000000000000000000000000000000000000001
1000000000000000000000000000000000000000000111100000000000000000000000000000000000000000000000000001
1000000000000000000000000000000000000000000111101111011110000000000000000000000000000000000000000001
1000000000000000000000000000000000000000000111101111011110000000000000000000000000000000000000000001
1000000000000000000000000000000000000000000111101111011110000000000000000000000000000000000000000001
1000000000000000000000000000000000000000000111101111011110000000000000000000000000000000000000000001
1000000000000000000000000000000000000000000111101111011110000000000000000000000000000000000000000001
1000000000000000000000000000000000000000000111101111011110000000000000000000000000000000000000000001
1000000000000000000000000000000000000000000111101111011110000000000000000000000000000000000000000001
1000000000000000000000000000000000000000000111101111011110000000000000000000000000000000000000000001
1000000000000000000000000000000000000000000111101111011110000000000000000000000000000000000000000001
1000000000000000000000000000000000000000000111101111011110000000000000000000000000000000000000000001
1000000000000000000000000000000000000000000111101111011110000000000000000000000000000000000000000001
1000000000000000000000000000000000000000000111101111011110000000000000000000000000000000000000000001
1000000000000000000000000000000000000000000111101111011110000000000000000000000000000000000000000001
1000000000000000000000000000000000000000000111101111011110000000000000000000000000000000000000000001
1000000000000000000000000000000000000000000111101111011110000000000000000000000000000000000000000001
1000000000000000000000000000000000000000000111101111011110000000000000000000000000000000000000000001
1000000000000000000000000000000000000000000111101111011110000000000000000000000000000000000000000001
1000000000000000000000000000000000000000000111101111011110000000000000000000000000000000000000000001
1111111111111111111111011111111111111111111111101111011111111111111111111111111111111111111111111111
1111111111111111111111011111111111111111111111101111011111111111111111111111111111111111111111111111
1111111111111111111111011111111111111111111111101111011111111111111111111111111111111111111111111111
1111111111111111111111011111111111111111111111101111011111111111111111111111111111111111111111111111
0000000000000000000000000000000000000000000000000000000000000000000000000000000000000000000000000000
1111111111111111111111011111111111111111111111100000011111111111111111111111111111111111111111111111
1111111111111111111111011111111111111111111111100000011111111111111111111111111111111111111111111111
1111111111111111111111011111111111111111111111100000011111111111111111111111111111111111111111111111
1111111111111111111111011111111111111111111111100000011111111111111111111111111111111111111111111111
0000000000000000000000000000000000000000000000000000000000000000000000000000000000000000000000000000
1111111111111111111111111111111111111111111111111011111111111111111111111111111111111111111111111111
1111111111111111111111111111111111111111111111111011111111111111111111111111111111111111111111111111
1111111111111111111111111111111111111111111111111011111111111111111111111111111111111111111111111111
1111111111111111111111111111111111111111111111111011111111111111111111111111111111111111111111111111
1000000000000000000000000000000000000000000000000000000000000000000000000000000000000000000000000001
1000000000000000000000000000000000000000000000000000000000000000000000000000000000000000000000000001
1000000000000000000000000000000000000000000000000000000000000000000000000000000000000000000000000001
1000000000000000000000000000000000000000000000000000000000000000000000000000000000000000000000000001
1000000000000000000000000000000000000000000000000000000000000000000000000000000000000000000000000001
1000000000000000000000000000000000000000000000000000000000000000000000000000000000000000000000000001
1000000000000000000000000000000000000000000000000000000000000000000000000000000000000000000000000001
1000000000000000000000000000000000000000000000000000000000000000000000000000000000000000000000000001
1000000000000000000000000000000000000000000000000000000000000000000000000000000000000000000000000001
1000000000000000000000000000000000000000000000000000000000000000000000000000000000000000000000000001
1000000000000000000000000000000000000000000000000000000000000000000000000000000000000000000000000001
1000000000000000000000000000000000000000000000000000000000000000000000000000000000000000000000000001
1000000000000000000000000000000000000000000000000000000000000000000000000000000000000000000000000001
1000000000000000000000000000000000000000000000000000000000000000000000000000000000000000000000000001
1000000000000000000000000000000000000000000000000000000000000000000000000000000000000000000000000001
1000000000000000000000000000000000000000000000000000000000000000000000000000000000000000000000000001
1000000000000000000000000000000000000000000000000000000000000000000000000000000000000000000000000001
1000000000000000000000000000000000000000000000000000000000000000000000000000000000000000000000000001
1000000000000000000000000000000000000000000000000000000000000000000000000000000000000000000000000001
1000000000000000000000000000000000000000000000000000000000000000000000000000000000000000000000000001
1000000000000000000000000000000000000000000000000000000000000000000000000000000000000000000000000001
1000000000000000000000000000000000000000000000000000000000000000000000000000000000000000000000000001
1000000000000000000000000000000000000000000000000000000000000000000000000000000000000000000000000001
1000000000000000000000000000000000000000000000000000000000000000000000000000000000000000000000000001
1000000000000000000000000000000000000000000000000000000000000000000000000000000000000000000000000001
1000000000000000000000000000000000000000000000000000000000000000000000000000000000000000000000000001
1000000000000000000000000000000000000000000000000000000000000000000000000000000000000000000000000001
1111111111111111111111111111111111111111111111111111111111111111111111111111111111111111111111111111
